1 1 1 1 1 4 1 1 1 1 
1 3 2 2 2 2 2 2 3 1 
1 2 2 1 1 1 1 2 2 1 
1 2 2 1 5 7 1 2 2 1 
4 2 2 1 0 8 1 2 2 4 
1 2 2 1 6 0 1 2 2 1 
1 2 2 1 1 1 1 2 2 1 
1 2 2 2 2 9 2 2 2 1 
1 3 2 2 2 2 2 2 3 1 
1 1 1 1 1 4 1 1 1 1 
10
